Linear Algebra Book:
*Linear Algebra Done Right - Sheldon Axler
*Matrix Analysis - Horn and Johnson
Matrix Analysis - Rajendra Bhatia (Grad Level Book)

Real Analysis:
Understanding Analysis - Abbott (Easier read than Rudin's famous book)
*Principles of Mathematical Analysis - Walter Rudin

Optimization:
*Convex Optimizatin - Stephen Boyd, Lieven Vandenberghe
Linear Programming - Robert Venderbei
Nonlinear Programming - Dimitri P. Bertsekas
Semidefinite Optimization - Monique Laurent
A First Course in Convex Optimization Theory - Ernest K. Ryu, Wotao Yin (Mainly Operator Algebra)

Machine Learning (General):
*Pattern Recognition and Machine Learning - Christopher Bishop

Statistical Learning:
The Elements of Statistical Learning - Trevor Hastie, Robert Tibshirani, Jerome Friedman
Statistical Learning with Sparsity: The Lasso and Generalizations - A. Martin Wainwright, Robert Tibshirani, and Trevor Hastie
Deep Learning - Aaron Courville, Ian Goodfellow, and Yoshua Bengio

Online Learning:
Adaptive Filer Theory - Simon Haykin
Introduction to online convex optimization - Elad Hazan

Reinforcement Learning:
Reinforcement Learning - An Introcudtion (2nd Edition) : Richard S. Sutton, Andrew G. Barto
Reinforcement Learning and Stochastic Optimization: A unified framework for sequential decisions - Warren Powell

Bayesian Learning:
Bayesian Data Analysis - Gelman
Probabilistic Graphical Models - Daphne Koller, Nir Friedman

Cuasal Inference:
The Book of Why - Judea Pearl, Dana Mackenzie
Causal Inerence in Statistics - Judea Pearl